test,10,10,0,0,8,8
0,0,0,0,0,0,0,0,0,1
1,1,0,0,0,0,1,0,0,0
0,0,1,0,0,1,A,1,0,0
0,0,0,1,0,0,1,0,0,0
0,0,0,0,1,0,0,0,0,0
0,0,0,0,0,1,0,0,0,0
0,0,0,0,0,0,1,0,0,0
0,0,0,0,0,0,0,1,0,0
0,0,0,0,0,0,0,0,0,1
1,0,0,0,0,0,0,0,1,1
